구분,지원,선발,선발취소,연기,입영,귀가,실입영
서울,9908,4316,59,51,4206,141,4065
부산,5168,1911,22,28,1861,91,1770
대구·경북,6506,2439,26,28,2385,112,2273
경인,8155,2953,36,37,2879,124,2755
광주·전남,4081,1636,20,32,1584,76,1508
대전·충남,3848,1475,13,18,1444,67,1377
강원,690,252,1,4,247,10,237
충북,1838,715,11,9,695,32,663
전북,1888,733,9,13,711,40,671
경남,4469,1577,10,14,1553,73,1480
제주,401,162,2,1,159,6,153
인천,5020,1862,19,22,1821,74,1747
경기북부,3232,1138,15,24,1099,36,1063
강원영동,387,135,0,3,132,4,128
