구분,지원,선발,선발취소,연기,입영,귀가,실입영
서울,1645,1140,16,18,1106,75,1031
부산,1693,1068,15,10,1043,66,977
대구·경북,2115,1609,26,29,1554,101,1453
경인,2019,1361,24,15,1322,81,1241
광주·전남,1206,885,10,14,861,57,804
대전·충남,1311,914,15,8,891,79,812
강원,268,187,1,7,179,14,165
충북,544,420,10,7,403,24,379
전북,632,486,8,6,472,38,434
경남,1384,857,22,12,823,47,776
제주,390,267,5,4,258,20,238
인천,1825,1269,25,15,1229,89,1140
경기북부,938,648,6,6,636,46,590
강원영동,154,112,3,4,105,5,100
